############################
.#..........................
.#...........|:.............
.#..........|##:............
......../[########:.........
...-../[###########]---\..-.
############################