30,30,30,30,30,30,30,30,30,30,30,30,30,30,30,30,30,30
30,0,0,0,0,0,0,0,0,3,0,0,0,0,0,0,0,31
30,0,0,0,0,0,0,0,0,18,0,0,0,0,3,0,0,31
30,0,0,0,0,0,0,0,0,0,8,9,8,9,3,2,1,30
30,0,0,0,0,0,0,7,8,9,7,0,0,0,0,1,2,30
30,0,0,0,7,8,9,1,2,3,0,0,0,0,0,2,1,30
30,0,0,0,0,0,0,0,0,0,0,0,0,0,12,1,2,30
30,0,0,0,0,0,0,0,0,0,0,0,12,13,7,2,1,30
30,0,0,0,0,0,0,0,0,0,0,0,0,0,0,1,2,30
30,7,8,9,7,8,9,7,8,9,7,8,9,7,8,9,8,30
30,30,30,30,30,30,30,30,30,30,30,30,30,30,30,30,30,30
