30,30,30,30,30,30,30,30,30,30,30,30,30,30,30,30,30,30
30,0,20,0,0,49,50,0,0,20,0,0,20,0,0,0,0,31
30,20,0,20,0,51,52,0,20,0,20,0,20,0,0,0,0,31
30,20,0,20,0,20,20,0,20,20,20,0,20,0,20,20,0,31
30,0,20,0,0,20,0,0,20,0,20,0,20,0,20,0,0,31
30,0,0,0,0,0,20,0,0,0,0,0,0,0,0,20,0,31
30,0,0,0,0,20,20,0,0,0,0,0,0,0,20,20,0,31
30,0,0,0,0,0,0,0,0,0,0,0,0,0,0,0,0,31
30,0,0,0,0,0,0,0,0,0,0,0,0,0,0,0,0,31
30,7,8,7,8,7,8,7,8,7,8,7,8,7,8,7,8,30
30,30,30,30,30,30,30,30,30,30,30,30,30,30,30,30,30,30
