30,30,30,30,30,30,30,30,30,30,30,30,30,30,30,30,30,30
31,0,0,0,0,0,0,0,0,0,0,0,0,0,0,0,6,30
31,0,0,0,3,0,0,0,0,0,0,0,0,0,0,0,6,30
31,0,0,0,1,66,0,0,0,0,0,0,0,1,0,0,2,30
31,0,0,0,1,0,0,0,0,0,0,0,0,0,0,0,6,30
30,7,8,9,0,0,0,0,0,0,0,0,0,0,0,0,6,30
30,0,0,0,0,0,0,0,0,0,0,0,0,0,0,0,2,30
30,0,0,0,0,2,0,0,0,0,0,9,8,9,8,9,8,30
30,0,0,0,0,0,0,0,0,0,0,3,2,3,2,3,2,30
30,7,8,7,8,7,8,7,8,7,8,7,8,7,8,7,8,30
30,30,30,30,30,30,30,30,30,30,30,30,30,30,30,30,30,30
