30,30,30,30,30,30,30,30,30,30,30,30,30,30,30,30,30,30
30,0,0,0,0,0,0,0,0,0,0,0,0,0,0,0,0,31
30,0,0,0,0,0,0,0,0,0,0,0,0,0,0,0,0,31
30,0,0,0,0,0,0,0,0,0,0,0,0,0,0,0,0,31
30,0,0,0,0,0,0,0,0,0,0,0,0,0,0,0,0,31
30,0,0,0,0,0,0,0,0,0,0,0,0,0,0,0,0,31
30,0,0,0,0,0,0,0,0,0,0,0,7,7,8,8,7,30
30,0,0,0,0,0,0,0,0,0,0,0,2,1,2,1,2,30
30,0,0,0,7,0,0,0,0,0,0,0,1,2,1,2,1,30
30,7,7,8,8,7,7,8,8,7,7,8,8,7,7,8,8,30
30,30,30,30,30,30,30,30,30,30,30,30,30,30,30,30,30,30
