30,30,30,30,30,30,30,30,30,30,30,30,30,30,30,30,30,30
30,0,0,0,0,0,0,0,0,0,0,0,0,0,0,0,0,31
30,0,0,0,0,0,0,0,0,0,0,0,0,0,0,0,0,31
30,0,0,0,0,0,0,0,0,0,0,0,0,0,0,0,0,31
30,8,7,0,0,0,0,0,0,0,0,0,0,0,0,0,7,30
30,1,2,0,0,0,0,0,0,0,0,0,0,0,0,0,0,30
30,2,1,0,0,0,0,0,0,0,0,0,0,0,0,0,0,30
30,1,2,0,0,0,0,0,0,0,0,0,0,0,0,0,0,30
30,2,1,0,0,0,0,0,0,0,0,0,0,0,0,0,0,30
30,1,2,9,7,8,9,7,8,9,7,8,9,7,8,9,8,30
30,30,30,30,30,30,30,30,30,30,30,30,30,30,30,30,30,30
