30,30,30,30,30,30,30,30,30,30,30,30,30,30,30,30,30,30
30,0,0,0,0,0,0,0,0,0,0,0,0,0,0,0,6,30
30,0,0,3,0,0,0,0,0,0,0,0,0,0,0,0,6,30
30,0,0,0,0,0,0,0,0,0,0,0,0,0,0,0,2,30
30,0,0,0,0,0,0,0,0,0,0,0,0,0,0,0,6,30
30,7,8,0,0,0,0,0,0,0,0,0,0,0,0,0,6,30
30,0,0,0,0,0,0,0,0,0,0,0,3,3,2,3,2,31
30,0,0,0,7,8,0,0,0,0,0,2,1,0,0,0,0,31
30,0,0,0,0,0,0,0,0,0,0,1,2,0,0,0,0,31
30,7,8,7,8,7,8,7,8,7,8,7,8,7,8,7,8,30
30,30,30,30,30,30,30,30,30,30,30,30,30,30,30,30,30,30
