19,19,19,19,19,19,19,19,19,19,19,19,19,19,19,19
19,19,19,19,19,19,19,19,19,19,19,19,19,19,19,19
19,19,19,19,19,19,19,19,19,19,19,19,19,19,19,19
19,19,19,19,19,19,19,19,19,19,19,19,19,19,19,19
19,19,19,19,19,19,19,19,19,19,19,7,7,8,8,7
19,19,19,19,19,19,5,5,19,19,19,2,1,2,1,2
19,19,19,7,19,19,19,19,19,19,19,1,2,1,2,1
7,7,8,8,7,7,8,8,7,7,8,8,7,7,8,8
2,2,1,1,2,2,1,1,2,2,1,1,2,2,1,1
