30,30,30,30,30,30,30,30,30,30,30,30,30,30,30,30,30,30
30,0,0,0,0,0,0,0,0,0,0,0,0,0,0,0,0,30
30,0,0,0,0,0,0,0,0,0,0,0,0,0,0,0,0,30
30,0,0,0,0,0,0,0,0,0,0,0,0,0,0,0,0,30
30,1,2,3,0,0,0,0,0,0,0,0,0,0,0,0,0,30
30,1,1,2,0,0,0,0,0,0,0,0,0,0,0,0,0,30
30,0,0,0,2,0,0,0,0,0,0,0,0,0,3,3,2,30
30,0,0,3,2,0,0,0,0,0,0,0,0,2,0,0,0,31
30,0,0,0,1,1,2,1,0,0,0,0,1,2,0,0,0,31
30,7,8,9,7,8,9,7,8,9,7,8,9,7,8,9,8,30
30,30,30,30,30,30,30,30,30,30,30,30,30,30,30,30,30,30
