30,30,30,30,30,30,30,30,30,30,30,30,30,30,30,30,30,30
30,0,0,0,0,0,0,0,0,0,0,0,0,55,56,57,0,30
30,0,0,0,0,0,0,0,0,0,0,0,0,58,59,0,0,30
30,0,0,0,0,0,0,0,0,0,0,0,0,61,0,0,0,30
30,0,0,0,0,0,0,0,0,0,0,0,0,0,0,0,0,30
30,0,0,0,0,0,0,0,0,0,0,0,0,0,0,0,0,30
30,0,0,0,0,0,0,0,0,0,0,0,0,0,0,0,0,30
30,0,0,0,0,66,0,0,0,0,0,0,0,0,0,0,0,30
30,0,65,65,65,66,65,65,64,65,65,65,65,65,65,65,0,30
30,1,2,9,7,8,9,7,8,9,7,8,9,7,8,9,8,30
30,30,30,30,30,30,30,30,30,30,30,30,30,30,30,30,30,30
